############
#         \L
#          #
#   #####  #
#       #  #
#       #  #
#       #  #
#       #  #
#       #  #
#       #  #
#R         #
############
